00011000
00300300
03111130
03011030
01000010
03333330
00000000
11100333
10000003
31300313