13311331
03000030
00100100
00033000
01311310
03111130
03033030
01000010
03300330
00000000