65623656
44411444
00312300
00066000
00321300
66311366
34633643
54066045
44011044
30066003