33311333
30000003
31022013
62033036
23011032
00066000
00133100
33366333
00333300
00066000
