40055004
06644660
04033040
05021060
64011050
00066043
00633600
00411400
06633660
43666634