06000060
32100113
11322311
31344313
12366321
31300313
61300316
06000060
04000040
63300336

