66632113
45411333
44400313
00003300
00366300
00440000
31300666
66123454
11333444
36300363