13100131
03100130
00311300
00013000
03322330
00011000
03333330
11000011
33300333
00000000