43600634
35600653
66600666
03000030
02000010
04000040
03300330
31166113
31422413
13666631
