00311300
10366301
30122103
30366303
30022003
16033061
63111136
23333332
31300313
06000060

