11300311
13000031
31033013
30033003
00100100
01000010
03111130
31333313
03100130
00000000
