35611366
44432344
06611360
00321300
00033000
00033000
00321300
06311650
44332444
66666666