30123103
30132103
30300303
31200213
33100133
30311303
30011003
03333330
00033000
00000000
