00300300
03022030
32066023
33022033
31000013
33133133
03366330
00311300
06033060
30000003