00044000
00455400
06444460
00033000
64332346
50600605
40300304
60600406
03166130
46633664