00644600
06132160
44123144
54311345
64133146
00623600
03066030
30066003
00633600
16666661
