0300000000000
0330000000000
0113000000000
0133300000000
0111130000000
0133333000000
0111111300000
0133323330000
0111111113000
0133333333300
0111121111300
0311111111130
0333333333330
0000000000000