00033000
00111100
03122130
33111133
03133130
00133100
03011030
03033030
30000003
00000000