66433466
41122114
06644660
10311303
30012001
00323300
03111130
43066034
30033003
00366300


