0000000000000
0000000000000
0000313130000
0001100011000
0003300033000
0031302031300
0033000003300
0011002001100
0011111111100
0011111111100
0000333330000
0311311131130
0311131311130
0000000000000