0000311130000
0000021200000
0000133310000
0000030300000
0000310130000
0003330333000
0001310131000
0133110133110
0133230323310
0313110113130
0033000003300
0033000003300
0331300031330
0333330333330