7000008000007
0000044400000
0000323230000
0000054500000
0050007000050
0663316133660
0383311133830
0100062600010
0300030300030
5730040400573
0006630366000
0066330336600
0033130313300
0000000000000