33111133
30033003
00311300
03200230
31000013
03100130
00311300
00033000
33333333
00000000