31313133
00000002
13131303
30000103
30360303
10360103
10300303
30333303
30000002
36666663