66422466
33166133
31111113
03644630
03012030
01021010
03333330
03044030
30066003
30033003