06044060
30233303
04012040
30166103
03031030
03322330
60066006
03100130
03033030
63600636
