00006600
00033300
00311203
03111303
33631613
33613616
03121302
00311203
00033300
00006600

