31000013
33111133
03111130
00311300
00022000
00033000
00311300
31333313
30000003
00000000