33166133
03000030
32300313
01133110
06133160
33100213
01000010
33133133
66600666
00000000
