13122131
30011003
30133103
31122113
03133130
00311300
00033000
00133100
03311330
30033003