00455400
30444406
60044003
21521516
60036006
54011045
44066044
00321300
06633660
66366366