0000008000009
0000020200000
0000013100000
0000031300000
0010004000080
0130204123000
0123000300230
0700032400010
0300030300030
0850040400573
0001390312000
001230008b600
0014a20013200
0000000000000