0000000000000
0000000000000
0000134020000
0001200012000
0000000013000
0004007010000
0082000003200
0041000000000
0030000002000
0012300040200
0000005010000
0310300340060
0121041300230
0000000000000