0300000000000
0040000000000
0012000000000
0000200000000
0100030000000
0000040000000
0200002300000
0123080030000
0a00000025000
0100000000300
0400323001300
0010000061230
0000012300000
0000000000000