0000017030000
0000031200000
0000126310000
0000020300000
0000310140000
0003b30421000
0001020030000
0132310182000
0122300424000
0310000433120
0035000001300
0000000000000
0121000001230
0132040123000