71000013
32161032
03412130
00313300
00042000
00031000
00311300
41323312
a0000002
00000000