00041000
00855400
03132430
00033000
04232b41
30200307
80300104
30900403
03152110
13a23434