00321300
10083201
10122103
30240301
30022003
150230b1
03213133
21039732
21300312
04000060

