00300100
03027030
32004023
34022038
31000013
53143132
01323130
0031b300
01033010
20000003