62311338
30000003
31022013
12031042
23011032
00042000
00133100
3b322137
00301400
00024000
