07048010
00431200
04012040
30214103
03091040
04322130
10011001
03100130
0b034030
13400132
