00000600
00031200
00311207
03141300
23231913
33813616
03121302
00211503
00032300
00004100

