43200438
35100270
12300321
03000030
02000010
04000040
02300230
211b3213
31301413
1342a431
