80032004
03342330
0403a040
06021030
24091070
00031043
00325100
0041b400
03125320
4193a234