02000010
32100113
18a23430
31344313
72322321
353003b1
21400312
03000020
01000040
23100430

