00253200
30121303
10034001
91341316
70023007
1401b042
42013023
00a41300
012b3210
a2334369