13211231
02000020
00100600
00030000
01311310
03212130
03033030
01000010
03400230
00000000