43112231
30032003
00347300
04200030
32000013
03100130
00210300
00032000
32134923
00000000