00184200
01332170
32123124
54311345
10132241
00123100
03012030
b0091003
00133200
6a131420
