54310328
43304344
30431407
10023001
30032003
50302300
40293204
10213401
30012003
b3008033
