25323153
31211024
0031b300
00032000
00361300
4231a312
74213143
580ba048
41091044
30054003