00011000
00300300
03122130
03011030
02000010
03053010
00000000
32100134
00000003
21400312