86431426
21132103
02134170
50311303
30012001
00321300
01123130
43009034
20013004
00312300


