21300318
13000031
31033013
20032003
00100600
01000010
03140130
31323213
03100530
00000000
