00023000
00133100
03132130
73141132
03135130
00230100
02011020
030b4030
20000001
00000000