21302123
380013b3
23100413
00003100
00423000
00240000
31200137
1292a354
41123231
52000132