30823103
30132103
30500903
31200213
a3100133
30341303
20001003
03122070
00041000
00000000
