12322813
13176130
04100123
00354630
03012030
04021010
0132a320
03012030
100b6003
40013002