21313232
00000002
10230203
30000104
20310301
10370102
10300204
302b2103
10000002
35042312