30132103
10148701
39132113
14500143
34200a41
20b12101
20023003
00001000
32133104
00013000
