13134136
30011003
30121003
37133113
03132130
00311300
0003b000
00122100
03411340
30013002